rows 84
cols 84
players 7
m ..%.%...%%%%..%%%%%%%%%%..%%.....%.....%%...%%....%%%.%%.%....%%%...%%%%..%.....%%..
m ..%%%%%%%%%%%%%%%%%%%%%%%%%%%....%%....%%....%...2.%%%%%%%%....%%...%%%%%%%%....%%%.
m ..6.%%%...%%.......%%%%...%%....%.%....%%...%.%....%....%%%...%......%%..%..%...%%%.
m .....................%................%%%...............%%..........%%...........%%.
m ....................%%%...............%%%...............%%..........%%...........%%.
m .....................%%...........2....%%...............%%%.........%%..........%%%.
m %%..%...%.....%%%...%%....%.%...%%%%%%%%%...%%%%%%%%%%%%%%%...%%.%%.%%%....%%.%.%%%%
m %%%%....%%....%%%%%%%%.....%%...%%%%%%%%%...%%%%%%%%%%%%%%....%%%%%%%%%....%%%%%%%%%
m .%%%.....%.....%..%%%%%....%%.....%%.%......%%%%%.%%..%%%%%....%%..%%%%...%....%%%%.
m ..%%%...%%%...............%%%...............%%%...............%%.1...............%..
m ..%%%...%%................%%................%%%...............%%.................%%.
m ...%%....%%...............%%................%%%................%%...............%%%.
m ...%%...%%....%%%.%%.%....%%%...%%%%..%.....%%....%.%...%%%%..%%%%%%%%%%..%%.....%..
m ...%%....%...3.%%%%%%%%....%%...%%%%%%%%....%%%...%%%%%%%%%%%%%%%%%%%%%%%%%%%....%%.
m ...%%...%.%....%....%%%...%......%%..%..%...%%%...0.%%%...%%.......%%%%...%%....%.%.
m ..%%%...............%%..........%%...........%%......................%..............
m ..%%%...............%%..........%%...........%%.....................%%%.............
m ...%%...............%%%.........%%..........%%%......................%%...........3.
m %%%%%...%%%%%%%%%%%%%%%...%%.%%.%%%....%%.%.%%%%%%..%...%.....%%%...%%....%.%...%%%%
m %%%%%...%%%%%%%%%%%%%%....%%%%%%%%%....%%%%%%%%%%%%%....%%....%%%%%%%%.....%%...%%%%
m .%......%%%%%.%%..%%%%%....%%..%%%%...%....%%%%..%%%.....%.....%..%%%%%....%%.....%%
m ........%%%...............%%.2...............%....%%%...%%%...............%%%.......
m ........%%%...............%%.................%%...%%%...%%................%%........
m ........%%%................%%...............%%%....%%....%%...............%%........
m ..%.....%%....%.%...%%%%..%%%%%%%%%%..%%.....%.....%%...%%....%%%.%%.%....%%%...%%%%
m %%%%....%%%...%%%%%%%%%%%%%%%%%%%%%%%%%%%....%%....%%....%...4.%%%%%%%%....%%...%%%%
m .%..%...%%%...1.%%%...%%.......%%%%...%%....%.%....%%...%.%....%....%%%...%......%%.
m .........%%......................%................%%%...............%%..........%%..
m .........%%.....................%%%...............%%%...............%%..........%%..
m ........%%%......................%%...........4....%%...............%%%.........%%..
m ...%%.%.%%%%%%..%...%.....%%%...%%....%.%...%%%%%%%%%...%%%%%%%%%%%%%%%...%%.%%.%%%.
m ...%%%%%%%%%%%%%....%%....%%%%%%%%.....%%...%%%%%%%%%...%%%%%%%%%%%%%%....%%%%%%%%%.
m ..%....%%%%..%%%.....%.....%..%%%%%....%%.....%%.%......%%%%%.%%..%%%%%....%%..%%%%.
m .........%....%%%...%%%...............%%%...............%%%...............%%.3......
m .........%%...%%%...%%................%%................%%%...............%%........
m ........%%%....%%....%%...............%%................%%%................%%.......
m ..%%.....%.....%%...%%....%%%.%%.%....%%%...%%%%..%.....%%....%.%...%%%%..%%%%%%%%%%
m %%%%%....%%....%%....%...5.%%%%%%%%....%%...%%%%%%%%....%%%...%%%%%%%%%%%%%%%%%%%%%%
m ..%%....%.%....%%...%.%....%....%%%...%......%%..%..%...%%%...2.%%%...%%.......%%%%.
m ..............%%%...............%%..........%%...........%%......................%..
m ..............%%%...............%%..........%%...........%%.....................%%%.
m ..........5....%%...............%%%.........%%..........%%%......................%%.
m ..%.%...%%%%%%%%%...%%%%%%%%%%%%%%%...%%.%%.%%%....%%.%.%%%%%%..%...%.....%%%...%%..
m ...%%...%%%%%%%%%...%%%%%%%%%%%%%%....%%%%%%%%%....%%%%%%%%%%%%%....%%....%%%%%%%%..
m ...%%.....%%.%......%%%%%.%%..%%%%%....%%..%%%%...%....%%%%..%%%.....%.....%..%%%%%.
m ..%%%...............%%%...............%%.4...............%....%%%...%%%.............
m ..%%................%%%...............%%.................%%...%%%...%%..............
m ..%%................%%%................%%...............%%%....%%....%%.............
m ..%%%...%%%%..%.....%%....%.%...%%%%..%%%%%%%%%%..%%.....%.....%%...%%....%%%.%%.%..
m ...%%...%%%%%%%%....%%%...%%%%%%%%%%%%%%%%%%%%%%%%%%%....%%....%%....%...6.%%%%%%%%.
m ..%......%%..%..%...%%%...3.%%%...%%.......%%%%...%%....%.%....%%...%.%....%....%%%.
m ........%%...........%%......................%................%%%...............%%..
m ........%%...........%%.....................%%%...............%%%...............%%..
m ........%%..........%%%......................%%...........6....%%...............%%%.
m ..%%.%%.%%%....%%.%.%%%%%%..%...%.....%%%...%%....%.%...%%%%%%%%%...%%%%%%%%%%%%%%%.
m ..%%%%%%%%%....%%%%%%%%%%%%%....%%....%%%%%%%%.....%%...%%%%%%%%%...%%%%%%%%%%%%%%..
m ...%%..%%%%...%....%%%%..%%%.....%.....%..%%%%%....%%.....%%.%......%%%%%.%%..%%%%%.
m ..%%.5...............%....%%%...%%%...............%%%...............%%%.............
m ..%%.................%%...%%%...%%................%%................%%%.............
m ...%%...............%%%....%%....%%...............%%................%%%.............
m ..%%%%%%%%%%..%%.....%.....%%...%%....%%%.%%.%....%%%...%%%%..%.....%%....%.%...%%%%
m %%%%%%%%%%%%%%%%%....%%....%%....%...0.%%%%%%%%....%%...%%%%%%%%....%%%...%%%%%%%%%%
m .......%%%%...%%....%.%....%%...%.%....%....%%%...%......%%..%..%...%%%...4.%%%...%%
m .........%................%%%...............%%..........%%...........%%.............
m ........%%%...............%%%...............%%..........%%...........%%.............
m .........%%...........0....%%...............%%%.........%%..........%%%.............
m ..%%%...%%....%.%...%%%%%%%%%...%%%%%%%%%%%%%%%...%%.%%.%%%....%%.%.%%%%%%..%...%...
m ..%%%%%%%%.....%%...%%%%%%%%%...%%%%%%%%%%%%%%....%%%%%%%%%....%%%%%%%%%%%%%....%%..
m ...%..%%%%%....%%.....%%.%......%%%%%.%%..%%%%%....%%..%%%%...%....%%%%..%%%.....%..
m ..............%%%...............%%%...............%%.6...............%....%%%...%%%.
m ..............%%................%%%...............%%.................%%...%%%...%%..
m ..............%%................%%%................%%...............%%%....%%....%%.
m ..%%%.%%.%....%%%...%%%%..%.....%%....%.%...%%%%..%%%%%%%%%%..%%.....%.....%%...%%..
m .1.%%%%%%%%....%%...%%%%%%%%....%%%...%%%%%%%%%%%%%%%%%%%%%%%%%%%....%%....%%....%..
m ...%....%%%...%......%%..%..%...%%%...5.%%%...%%.......%%%%...%%....%.%....%%...%.%.
m ........%%..........%%...........%%......................%................%%%.......
m ........%%..........%%...........%%.....................%%%...............%%%.......
m ........%%%.........%%..........%%%......................%%...........1....%%.......
m %%%%%%%%%%%...%%.%%.%%%....%%.%.%%%%%%..%...%.....%%%...%%....%.%...%%%%%%%%%...%%%%
m %%%%%%%%%%....%%%%%%%%%....%%%%%%%%%%%%%....%%....%%%%%%%%.....%%...%%%%%%%%%...%%%%
m %.%%..%%%%%....%%..%%%%...%....%%%%..%%%.....%.....%..%%%%%....%%.....%%.%......%%%%
m ..............%%.0...............%....%%%...%%%...............%%%...............%%%.
m ..............%%.................%%...%%%...%%................%%................%%%.
m ...............%%...............%%%....%%....%%...............%%................%%%.

